1080 0 0 0 0 0 0 0 0 0 0 0 0 0 0 0 0 0 0 0 0 0 0 0 0 0 0 0 0 0 0 0 0 0 0 0 0 0 0 0 0 0 0 0 0 0 0 0 0 0 0 0 0 0 0 0 0 0 0 0 0 0 0 0 0 0 0 0 0 0 0 0 0 0 0 0 0 0 0 0 0 0 0 0 0 0 0 0 0 0 0 0 1080
1080 0 0 0 0 0 0 0 0 0 0 0 0 0 0 0 0 0 0 0 0 0 0 0 0 0 0 0 0 0 0 0 0 0 0 0 0 0 0 0 0 0 0 0 0 0 0 0 0 0 0 0 0 0 0 0 0 0 0 0 0 0 0 0 0 0 0 0 0 0 0 0 0 0 0 0 0 0 0 0 0 0 0 0 0 0 0 0 0 0 0 0 1080
1080 0 0 0 0 0 0 0 0 0 0 0 0 0 0 0 0 0 0 0 0 0 0 0 0 0 0 0 0 0 0 0 0 0 0 0 0 0 0 0 0 0 0 0 0 0 0 0 0 0 0 0 0 0 0 0 0 0 0 0 0 0 0 0 0 0 0 0 0 0 0 0 0 0 0 0 0 0 0 0 0 0 0 0 0 0 0 0 0 0 0 0 1080
1080 0 0 0 0 0 0 0 0 0 0 0 0 0 0 0 0 0 0 0 0 0 0 0 0 0 0 0 0 0 0 0 0 0 0 0 0 0 0 0 0 0 0 0 0 0 0 0 0 0 0 0 0 0 0 0 0 0 0 0 0 0 0 0 0 0 0 0 0 0 0 0 0 0 0 0 0 0 0 0 0 0 0 0 0 0 0 0 0 0 0 0 1080
1080 0 0 0 0 0 0 0 0 0 0 0 0 0 0 0 0 0 0 0 0 0 0 0 0 0 0 0 0 0 0 0 0 0 0 0 0 0 0 0 0 0 0 0 0 0 0 0 0 0 0 0 0 0 0 0 0 0 0 0 0 0 0 0 0 0 0 0 0 0 0 0 0 0 0 0 0 0 0 0 0 0 0 0 0 0 0 0 0 0 1058 1058 1058
1080 0 0 0 0 0 0 0 0 0 0 0 0 0 0 0 0 0 0 0 0 0 0 0 0 0 0 0 0 0 0 0 0 0 0 0 0 0 0 0 0 0 0 0 0 0 0 0 0 0 0 0 0 0 0 0 0 0 0 0 0 0 0 0 0 0 0 0 0 0 0 0 0 0 0 0 0 0 0 0 0 0 0 0 0 0 0 0 0 1058 1107 1107 1107
1080 0 0 0 0 0 0 0 0 0 0 0 0 0 0 0 0 0 0 0 0 0 0 0 0 0 0 0 0 0 0 0 0 0 0 0 0 0 0 0 0 0 0 0 0 0 0 0 0 0 0 0 0 0 0 0 0 0 0 0 0 0 0 0 0 0 0 0 0 0 0 0 0 0 0 0 0 0 0 0 0 0 0 0 0 0 0 0 0 1107 1107 1107 1107
1080 0 0 0 0 0 0 0 0 0 0 0 0 0 0 0 0 0 0 0 0 0 0 0 0 0 0 0 0 0 0 0 0 0 0 0 0 0 0 0 0 0 0 0 0 0 0 0 0 0 0 0 0 0 0 0 0 0 0 0 0 0 0 0 0 0 0 0 0 0 0 0 0 0 0 0 0 0 0 0 0 0 0 0 0 0 0 1058 1058 1107 1107 1107 1107
1080 0 0 0 0 0 0 0 0 0 0 0 0 0 0 0 0 0 0 0 0 0 0 0 0 0 0 0 0 0 0 0 0 0 0 0 0 0 0 0 0 0 0 0 0 0 0 0 0 0 0 0 0 0 0 0 0 0 0 0 0 0 0 0 0 0 0 0 0 0 0 0 0 0 0 0 0 0 0 0 0 0 0 0 0 0 0 1107 1107 1107 1107 1107 1107
1080 0 0 0 0 0 0 0 0 0 0 0 0 0 0 0 0 0 0 0 0 0 0 0 0 0 0 0 0 0 0 0 0 0 0 1081 1058 1058 1058 1058 1058 0 0 0 0 0 0 0 0 0 0 0 0 0 0 0 0 0 0 0 0 0 0 0 0 0 0 0 0 0 0 0 0 0 0 0 0 0 0 0 0 0 0 0 0 1058 1058 1107 1107 1107 1107 1107 1107
1080 0 0 0 0 0 0 0 0 0 0 0 0 0 0 0 0 0 0 0 0 0 0 0 0 0 0 0 0 0 0 0 0 0 1081 1083 0 0 0 0 1083 1058 0 0 0 0 0 0 0 0 0 0 0 0 0 0 0 1058 1058 1058 0 0 0 0 0 0 0 0 0 0 0 0 0 0 0 0 0 0 0 0 0 0 0 0 1058 1107 1107 1107 1107 1107 1107 1107 1107
1080 0 0 0 0 0 0 0 0 0 0 0 0 0 0 0 0 0 0 0 0 0 0 0 0 0 0 0 0 0 0 0 0 0 0 0 0 0 0 0 1083 1083 1058 0 0 0 0 0 0 0 0 0 0 0 0 1058 1058 1083 1083 1083 0 0 0 0 0 0 0 0 0 0 0 0 0 0 0 0 0 0 0 0 0 0 0 0 1107 1107 1107 1107 1107 1107 1107 1107 1107
1080 0 0 0 0 0 0 0 0 0 0 0 0 0 0 0 1058 1058 1058 1058 0 0 0 0 0 0 0 0 0 0 0 0 0 0 0 0 0 0 0 0 1083 1083 1083 0 0 0 0 0 0 0 0 0 0 1058 1058 1083 1083 1083 1083 1083 0 0 0 0 0 0 0 0 0 0 0 0 0 0 0 0 0 0 0 0 0 0 1058 1058 1107 1107 1107 1107 1107 1107 1107 1107 1107
1080 0 0 0 0 0 0 0 0 0 0 0 0 1058 1058 1058 1083 1083 1083 1083 0 0 0 0 0 0 0 0 0 0 0 0 0 0 0 0 0 0 0 0 1083 1083 1083 0 0 0 1058 1058 1058 1058 1058 1058 1058 1083 1083 1083 1083 1083 1083 1083 0 0 0 0 0 0 0 0 0 0 0 0 0 0 0 0 0 0 0 0 0 0 1107 1107 1107 1107 1107 1107 1107 1107 1107 1107 1107
1058 1058 1058 1058 1058 1058 1058 1058 1058 1058 1058 1058 1058 1083 1083 1083 1083 1083 1083 1083 1058 1058 1058 1058 1058 1058 1058 1058 1058 1058 1058 1058 1058 1058 1058 1058 0 0 0 0 1083 1083 1083 1058 1058 1058 1083 1083 1083 1083 1083 1083 1083 1083 1083 1083 1083 1083 1083 1083 1058 1058 1058 1058 1058 1058 1058 1058 1058 1058 1058 1058 1058 1058 1058 1058 0 0 0 0 1058 1058 1107 1107 1107 1107 1107 1107 1107 1107 1107 1107 1107
1083 1108 1083 1083 1083 1083 1108 1083 1083 1083 1108 1083 1108 1083 1083 1108 1083 1083 1108 1083 1108 1083 1083 1108 1083 1083 1108 1083 1083 1083 1083 1083 1108 1083 1083 1083 0 0 0 0 1108 1083 1083 1083 1083 1108 1083 1083 1108 1083 1083 1108 1083 1108 1083 1083 1108 1083 1083 1108 1083 1083 1083 1083 1108 1083 1083 1108 1083 1083 1108 1083 1083 1083 1108 1083 0 0 0 0 1083 1083 1083 1108 1083 1108 1083 1083 1108 1083 1108 1083 1083
1083 1108 1083 1108 1083 1108 1083 1083 1108 1083 1108 1083 1108 1083 1083 1108 1083 1083 1083 1083 1108 1083 1108 1083 1083 1083 1108 1083 1083 1083 1108 1083 1108 1083 1108 1083 0 0 0 0 1108 1083 1108 1083 1108 1083 1083 1083 1108 1083 1083 1083 1083 1108 1083 1108 1083 1108 1083 1083 1083 1083 1108 1083 1108 1083 1083 1083 1108 1083 1083 1083 1083 1083 1083 1083 0 0 0 0 1108 1083 1083 1083 1083 1108 1083 1083 1083 1108 1083 1108 1083
1108 1083 1108 1083 1083 1108 1083 1083 1108 1083 1083 1108 1083 1083 1083 1108 1083 1108 1083 1083 1108 1083 1083 1083 1083 1108 1083 1083 1108 1108 1083 1108 1083 1083 1083 1108 0 0 0 0 1083 1083 1108 1083 1083 1083 1083 1083 1083 1083 1083 1108 1083 1083 1083 1108 1083 1083 1083 1083 1108 1108 1083 1108 1083 1083 1108 1083 1108 1083 1083 1083 1083 1108 1083 1083 0 0 0 0 1083 1108 1083 1108 1083 1083 1083 1083 1083 1083 1083 1108 1083
1083 1083 1083 1083 1083 1083 1083 1108 1083 1108 1083 1108 1083 1108 1083 1083 1083 1083 1108 1083 1108 1083 1083 1083 1108 1083 1108 1083 1083 1083 1108 1083 1083 1108 1083 1108 0 0 0 0 1083 1083 1083 1083 1108 1083 1108 1083 1108 1083 1083 1108 1083 1108 1083 1108 1083 1108 1083 1083 1083 1108 1083 1083 1083 1108 1083 1083 1083 1108 1083 1083 1083 1108 1083 1108 0 0 0 0 1083 1083 1083 1108 1083 1083 1108 1083 1108 1083 1108 1083 1108
1108 1083 1108 1083 1083 1108 1083 1083 1108 1083 1108 1083 1108 1083 1083 1108 1083 1108 1108 1108 1083 1108 1083 1083 1108 1083 1108 1108 1083 1183 1183 1183 1108 1083 1108 1083 0 0 0 0 1108 1108 1083 1083 1083 1083 1108 1083 1108 1108 1108 1083 1108 1083 1108 1083 1108 1083 1083 1083 1083 1108 1108 1083 1108 1083 1083 1108 1083 1108 1108 1083 1108 1083 1108 1083 0 0 0 0 1108 1083 1108 1083 1108 1108 1083 1108 1083 1083 1108 1083 1108
1083 1083 1083 1083 1233 1233 1233 1233 1233 1233 1233 1233 1233 1233 1233 1233 1233 1233 1233 1233 1233 1233 1233 1233 1233 1233 1233 1233 1233 1233 1233 1233 1233 1233 1233 1233 1233 1233 1233 1233 1233 1233 1233 1233 1083 1083 1083 1083 1083 1083 1083 1083 1083 1083 1083 1083 1083 1083 1083 1083 1083 1083 1083 1083 1083 1083 1083 1083 1083 1083 1083 1083 1233 1233 1233 1233 1233 1233 1233 1233 1233 1233 1233 1233 1233 1233 1233 1233 1233 1083 1083 1083 1083
1083 1083 1233 1233 1233 1233 1233 1233 1233 1233 1233 1233 1233 1233 1233 1233 1233 1233 1233 1233 1233 1233 1233 1233 1233 1233 1233 1233 1233 1233 1233 1233 1233 1233 1233 1233 1233 1233 1233 1233 1233 1233 1233 1233 1233 1083 1083 1083 1083 1202 1202 1202 1202 1202 1202 1083 1083 1202 1202 1202 1202 1202 1083 1083 1083 1083 1083 1083 1233 1233 1233 1233 1233 1233 1233 1233 1233 1233 1233 1233 1233 1233 1233 1233 1233 1233 1233 1233 1233 1233 1083 1083 1083
1083 1233 1233 1233 1233 1233 1233 1233 1233 1233 1233 1233 1233 1233 1233 1233 1233 1233 1233 1233 1233 1233 1233 1233 1233 1233 1233 1233 1233 1233 1233 1233 1233 1233 1233 1233 1233 1233 1233 1233 1233 1233 1233 1233 1233 1233 1233 1083 1083 1202 1227 1227 1202 1202 1202 1202 1227 1227 1202 1202 1083 1083 1083 1083 1083 1083 1233 1233 1233 1233 1233 1233 1233 1233 1233 1233 1233 1233 1233 1233 1233 1233 1233 1233 1233 1233 1233 1233 1233 1233 1233 1083 1083
1083 1233 1233 1233 1233 1233 1233 1233 1233 1233 1233 1233 1233 1233 1233 1233 1233 1233 1233 1233 1233 1233 1233 1233 1233 1233 1233 1233 1233 1233 1233 1233 1233 1233 1233 1233 1233 1233 1233 1233 1233 1233 1233 1233 1233 1233 1233 1233 1083 1202 1227 1227 1202 1202 1227 1227 1227 1227 1227 1202 1083 1083 1083 1083 1083 1233 1233 1233 1233 1233 1233 1233 1233 1233 1233 1233 1233 1233 1233 1233 1233 1233 1233 1233 1233 1233 1233 1233 1233 1233 1233 1233 1083
1083 1233 1233 1233 1233 1233 1233 1233 1233 1233 1233 1233 1233 1233 1233 1233 1233 1233 1233 1233 1233 1233 1083 1083 1083 1083 1083 1083 1233 1233 1233 1233 1233 1233 1233 1233 1233 1233 1233 1233 1233 1233 1233 1233 1233 1233 1233 1233 1083 1202 1201 1202 1227 1202 1227 1202 1227 1202 1227 1227 1083 1083 1083 1083 1233 1233 1233 1233 1233 1233 1233 1233 1233 1233 1233 1233 1233 1233 1233 1233 1233 1233 1233 1233 1233 1233 1233 1233 1233 1233 1233 1233 1083
1083 1233 1233 1233 1233 1233 1233 1233 1233 1233 1233 1233 1233 1233 1233 1233 1233 1233 1233 1233 1233 1233 1083 1083 1083 1083 1083 1083 1233 1233 1233 1233 1233 1233 1233 1233 1233 1233 1233 1233 1233 1233 1233 1233 1233 1233 1233 1233 1083 1083 1083 1202 1202 1227 1227 1227 1227 1227 1227 1227 1227 1083 1083 1083 1233 1233 1233 1233 1233 1233 1233 1233 1233 1233 1233 1233 1233 1233 1233 1233 1233 1233 1233 1233 1233 1233 1233 1233 1233 1233 1233 1233 1083
1083 1233 1233 1233 1233 1233 1233 1083 1083 1083 1083 1233 1233 1233 1233 1083 1083 1083 1083 1233 1233 1233 1083 1083 1083 1083 1083 1083 1233 1233 1233 1233 1233 1233 1233 1233 1233 1233 1233 1233 1233 1233 1233 1233 1233 1233 1233 1233 1083 1083 1083 1202 1202 1227 1202 1202 1202 1202 1202 1227 1227 1083 1083 1083 1233 1233 1233 1233 1233 1233 1233 1233 1233 1233 1233 1233 1233 1233 1233 1233 1233 1233 1233 1233 1233 1233 1233 1233 1233 1233 1233 1233 1083
1083 1083 1208 1208 1208 1208 1208 1083 1083 1083 1083 1208 1208 1208 1208 1083 1083 1083 1083 1208 1208 1208 1083 1083 1083 1083 1083 1083 1208 1208 1208 1208 1208 1208 1208 1208 1208 1208 1208 1208 1208 1208 1208 1208 1208 1208 1208 1208 1083 1202 1202 1202 1202 1202 1202 1202 1083 1083 1202 1227 1202 1083 1083 1083 1083 1208 1208 1208 1208 1208 1208 1208 1208 1208 1208 1208 1208 1208 1208 1208 1208 1208 1208 1208 1208 1208 1208 1208 1208 1208 1208 1208 1083
1083 1083 1083 1083 1083 1208 1208 1083 1083 1083 1083 1208 1208 1208 1208 1083 1083 1083 1083 1208 1208 1208 1083 1083 1083 1083 1083 1083 1208 1208 1208 1208 1208 1208 1208 1208 1208 1208 1208 1208 1208 1208 1208 1208 1208 1208 1083 1083 1083 1202 1083 1083 1083 1083 1083 1202 1083 1083 1202 1202 1202 1083 1083 1083 1083 1083 1083 1208 1208 1208 1208 1208 1208 1208 1208 1208 1208 1208 1208 1208 1208 1208 1208 1208 1208 1208 1208 1208 1208 1208 1208 1208 1083
1083 1083 1083 1083 1083 1083 1083 1083 1083 1083 1083 1083 1208 1208 1208 1083 1083 1083 1083 1208 1208 1208 1083 1083 1083 1083 1083 1083 1083 1083 1208 1208 1208 1208 1208 1208 1208 1208 1208 1208 1208 1208 1208 1208 1083 1083 1083 1083 1083 1083 1083 1083 1083 1083 1083 1202 1083 1083 1083 1083 1202 1083 1083 1083 1083 1083 1083 1083 1083 1083 1083 1208 1208 1208 1208 1208 1208 1208 1208 1208 1208 1208 1208 1208 1208 1208 1208 1208 1208 1083 1083 1083 1083
1083 1083 1083 1083 1083 1083 1083 1083 1083 1083 1083 1083 1083 1083 1083 1083 1083 1083 1083 0 0 0 1083 1083 1083 1083 1083 1083 1083 1083 1083 1083 1083 1083 1083 1083 1083 1083 1083 1083 1083 1083 1083 1083 1083 1083 1083 1083 1083 1083 1083 1083 1083 1083 1083 1083 1083 1083 1083 1083 1083 1083 1083 1083 1083 1083 1083 1083 1083 1083 1083 1083 1083 1083 1083 1083 1083 1083 1083 1083 1083 1083 1083 0 0 0 0 1083 1083 1083 1083 1083 1083
1083 1108 1083 1108 1083 1108 1083 1108 1083 1083 1083 1108 1083 1108 1083 1108 1083 1108 1083 0 0 0 1083 1108 1083 1108 1083 1108 1083 1083 1083 1108 1083 1108 1083 1108 1083 1108 1083 1083 1083 1108 1083 1108 1083 1108 1083 1108 1083 1083 1083 1108 1083 1108 1083 1108 1083 1108 1083 1083 1083 1108 1083 1108 1083 1108 1083 1108 1083 1083 1083 1108 1083 1108 1083 1108 1083 1108 1083 1083 1083 1108 1083 0 0 0 0 1083 1108 1083 1108 1083 1083
1108 1083 1108 1083 1083 1108 1083 1108 1108 1083 1108 1083 1108 1083 1083 1108 1083 1108 1108 0 0 0 1108 1083 1083 1108 1083 1108 1108 1083 1108 1083 1108 1083 1083 1108 1083 1108 1108 1083 1108 1083 1108 1083 1083 1108 1083 1108 1108 1083 1108 1083 1108 1083 1083 1108 1083 1108 1108 1083 1108 1083 1108 1083 1083 1108 1083 1108 1108 1083 1108 1083 1108 1083 1083 1108 1083 1108 1108 1083 1108 1083 1108 0 0 0 0 1083 1108 1083 1108 1108 1083
1083 1083 1083 1083 1083 1083 1083 1083 1083 1083 1083 1083 1083 1083 1083 1233 1233 1233 1233 1233 1233 1233 1233 1233 1233 1233 1233 1233 1233 1233 1233 1233 1233 1233 1233 1083 1083 1083 1083 1083 1083 1083 1083 1083 1083 1083 1083 1083 1083 1083 1083 1083 1083 1083 1083 1083 1083 1083 1083 1083 1083 1083 1083 1083 1083 1083 1083 1083 1083 1233 1233 1233 1233 1233 1233 1233 1233 1233 1233 1233 1233 1233 1233 1233 1233 1233 1233 1233 1083 1083 1083 1083 1083
1083 1083 1083 1083 1083 1083 1083 1083 1083 1083 1083 1083 1083 1233 1233 1233 1233 1233 1233 1233 1233 1233 1233 1233 1233 1233 1233 1233 1233 1233 1233 1233 1233 1233 1233 1233 1233 1083 1083 1083 1083 1083 1083 1083 1083 1083 1083 1083 1083 1083 1083 1083 1083 1083 1083 1083 1083 1083 1083 1083 1083 1083 1083 1083 1083 1083 1083 1083 1233 1233 1233 1233 1233 1233 1233 1233 1233 1233 1233 1233 1233 1233 1233 1233 1233 1233 1233 1233 1233 1233 1083 1083 1083
1083 1083 1083 1083 1083 1083 1083 1083 1233 1233 1233 1233 1233 1233 1233 1233 1233 1233 1233 1233 1233 1233 1233 1233 1233 1233 1233 1233 1233 1233 1233 1233 1233 1233 1233 1233 1233 1233 1233 1233 1083 1083 1083 1083 1083 1083 1083 1083 1083 1083 1083 1083 1083 1083 1083 1083 1083 1083 1083 1083 1083 1083 1083 1083 1083 1233 1233 1233 1233 1233 1233 1233 1233 1233 1233 1233 1233 1233 1233 1233 1233 1233 1233 1233 1233 1233 1233 1233 1233 1233 1233 1083 1083
1083 1083 1083 1083 1233 1233 1233 1233 1233 1233 1233 1233 1233 1233 1233 1233 1233 1233 1233 1233 1233 1233 1233 1233 1233 1233 1233 1233 1233 1233 1233 1233 1233 1233 1233 1233 1233 1233 1233 1233 1233 1233 1233 1233 1083 1083 1083 1083 1083 1083 1083 1083 1083 1083 1083 1083 1083 1083 1083 1083 1083 1083 1083 1233 1233 1233 1233 1233 1233 1233 1233 1233 1233 1233 1233 1233 1233 1233 1233 1233 1233 1233 1233 1233 1233 1233 1233 1233 1233 1233 1233 1233 1083
1083 1233 1233 1233 1233 1233 1233 1233 1233 1233 1233 1233 1233 1233 1233 1233 1233 1233 1233 1233 1233 1233 1233 1233 1233 1233 1233 1233 1233 1233 1233 1233 1233 1233 1233 1233 1233 1233 1233 1233 1233 1233 1233 1233 1233 1233 1233 1083 1083 1083 1083 1083 1083 1083 1083 1083 1083 1083 1083 1233 1233 1233 1233 1233 1233 1233 1233 1233 1233 1233 1233 1233 1233 1233 1233 1233 1233 1233 1233 1233 1233 1233 1233 1233 1233 1233 1233 1233 1233 1233 1233 1233 1083
1083 1233 1233 1233 1233 1233 1233 1233 1233 1233 1233 1233 1233 1233 1233 1233 1233 1233 1233 1233 1233 1233 1233 1233 1233 1233 1233 1233 1233 1233 1233 1233 1233 1233 1233 1233 1233 1233 1233 1233 1233 1233 1233 1233 1233 1233 1233 1233 1233 1233 1083 1083 1083 1083 1083 1083 1083 1083 1233 1233 1233 1233 1233 1233 1233 1233 1233 1233 1233 1233 1233 1233 1233 1233 1233 1233 1233 1233 1233 1233 1233 1233 1233 1233 1233 1233 1233 1233 1233 1233 1233 1233 1083
1083 1083 1233 1233 1233 1233 1233 1233 1233 1233 1233 1233 1233 1233 1233 1233 1233 1233 1233 1233 1233 1233 1233 1083 1083 1233 1233 1233 1233 1233 1233 1233 1233 1233 1233 1233 1233 1233 1233 1233 1233 1083 1083 1083 1233 1233 1233 1233 1233 1233 1233 1083 1083 1083 1083 1083 1083 1233 1233 1233 1233 1233 1233 1233 1233 1233 1233 1233 1233 1233 1233 1233 1233 1233 1233 1233 1233 1233 1233 1233 1233 1233 1233 1233 1233 1233 1233 1233 1083 1083 1083 1083 1083
1083 1083 1083 1233 1233 1233 1233 1233 1233 1233 1233 1233 1233 1233 1233 1233 1233 1233 1233 1233 1233 1083 1083 1083 1083 1083 1233 1233 1233 1233 1233 1233 1233 1233 1233 1233 1233 1233 1233 1233 1233 1083 1083 1083 1083 1233 1233 1233 1233 1233 1233 1233 1233 1233 1233 1233 1233 1233 1233 1233 1233 1233 1233 1233 1233 1233 1233 1233 1233 1233 1233 1233 1233 1233 1233 1233 1233 1233 1233 1233 1233 1233 1233 1233 1233 1233 1233 1083 1083 1083 1083 1083 1083
1083 1083 1083 1083 1233 1233 1233 1233 1233 1233 1233 1233 1233 1233 1233 1233 1233 1233 1233 1083 1083 1083 1083 1083 1083 1083 1083 1083 1233 1233 1233 1233 1233 1233 1233 1233 1233 1233 1233 1233 1233 1083 1083 1083 1083 1083 1233 1233 1233 1233 1233 1233 1233 1233 1233 1233 1233 1233 1233 1233 1233 1233 1233 1233 1233 1233 1233 1233 1233 1233 1233 1233 1233 1233 1233 1233 1233 1233 1233 1233 1233 1233 1233 1233 1233 1083 1083 1083 1083 1083 1083 1083 1083
1083 1083 1083 1083 1083 1233 1233 1233 1233 1233 1083 1083 1083 1083 1083 1083 1083 1083 1083 1083 1083 1083 1083 1083 1083 1083 1083 1083 1083 1083 1083 1083 1083 1083 1083 1083 1083 1083 1083 1083 1083 1083 1083 1083 1083 1083 1083 1233 1233 1233 1083 1083 1083 1083 1083 1083 1083 1083 1083 1083 1083 1083 1083 1083 1083 1083 1083 1083 1083 1083 1083 1083 1083 1083 1083 1083 1083 1083 1083 1083 1083 1083 1083 1083 1083 1083 1083 1083 1083 1083 1083 1083 1083
1083 1083 1083 1108 1108 0 0 0 0 0 1108 1108 1108 1108 1108 1108 1108 1108 1108 1108 1108 1108 1108 1108 1108 1108 1108 1108 1108 1108 1108 1108 1108 1108 1108 1108 1108 1108 1108 1108 1108 1108 1108 1108 1108 1083 1083 1083 1083 1083 1083 1083 1083 1108 1108 1108 1108 1108 1108 1108 1108 1108 1108 1108 1108 1108 1108 1108 1108 1108 1108 1108 1108 1108 1108 1108 1108 1108 1108 1108 1108 1108 1108 1108 1108 1108 1108 1108 1108 1108 1108 1108 1108
1083 1083 1108 1108 1108 0 0 0 0 0 1108 1108 1108 1108 1108 1108 1108 1108 1108 1108 1108 1108 1108 1108 1108 1108 1108 1108 1108 1108 1108 1108 1108 1108 1108 1108 1108 1108 1108 1108 1108 1108 1108 1108 1108 1108 1108 1108 1108 1108 1108 1108 1108 1108 1108 1108 1108 1108 1108 1108 1108 1108 1108 1108 1108 1108 1108 1108 1108 1108 1108 1108 1108 1108 1108 1108 1108 1108 1108 1108 1108 1108 1108 1108 1108 1108 1108 1108 1108 1108 1108 1108 1108
1083 1108 1108 1108 1108 0 0 0 0 0 1108 1108 1108 1108 1108 1108 1108 1108 1108 1108 1108 1108 1108 1108 1108 1108 1108 1108 1108 1108 1108 1108 1108 1108 1108 1108 1108 1108 1108 1108 1108 1108 1108 1108 1108 1108 1108 1108 1108 1108 1108 1108 1108 1108 1108 1108 1108 1108 1108 1108 1108 1108 1108 1108 1108 1108 1108 1108 1108 1108 1108 1108 1108 1108 1108 1108 1108 1108 1108 1108 1108 1108 1108 1108 1108 1108 1108 1108 1108 1108 1108 1108 1108
1108 1108 1108 1108 1108 0 0 0 0 0 1108 1108 1108 1108 1108 1108 1108 1108 1108 1108 1108 1108 1108 1108 1108 1108 1108 1108 1108 0 0 0 0 0 0 0 0 0 0 0 0 0 0 0 0 0 0 0 0 0 0 0 0 0 0 0 0 0 0 0 0 0 0 0 0 0 0 0 0 0 0 0 0 0 0 0 0 0 0 0 0 0 0 0 0 0 0 0 0 0 0 0 1080
1108 1108 1108 1108 1108 0 0 0 0 0 1108 1108 1108 1108 1108 1108 1108 1108 1108 1108 1108 1108 1108 1108 1108 0 0 0 0 0 0 0 0 0 0 0 0 0 0 0 0 0 0 0 0 0 0 0 0 0 0 0 0 0 0 0 0 0 0 0 0 0 0 0 0 0 0 0 0 0 0 0 0 0 0 0 0 0 0 0 0 0 0 0 0 0 0 0 0 0 0 0 1080
1108 1108 1108 1108 1108 0 0 0 0 0 1108 1108 1108 1108 1108 1108 1108 1108 1108 1108 1108 1108 1108 1108 0 0 0 0 0 0 0 0 0 0 0 0 0 0 0 0 0 0 0 0 0 0 0 0 0 0 0 0 0 0 0 0 0 0 0 0 0 0 0 0 0 0 0 0 0 0 0 0 0 0 0 0 0 0 0 0 0 0 0 0 0 0 0 0 0 0 0 0 1080
1108 1108 1108 1108 1108 0 0 0 0 0 1108 1108 1108 1108 1108 1108 1108 1108 1108 1108 1108 1108 1108 0 0 0 0 0 0 0 0 0 0 0 0 0 0 0 0 0 0 0 0 0 0 0 0 0 0 0 0 0 0 0 0 0 0 0 0 0 0 0 0 0 0 0 0 0 0 0 0 0 0 0 0 0 0 0 0 0 0 0 0 0 0 0 0 0 0 0 0 0 1080
1108 1108 1108 1108 1108 0 0 0 0 0 1108 1108 1108 1108 1108 1108 1108 1108 1108 1108 1108 1108 0 0 0 0 0 0 0 0 0 0 0 0 0 0 0 0 0 0 0 0 0 0 0 0 0 0 0 0 0 0 0 0 0 0 0 0 0 0 0 0 0 0 0 0 0 0 0 0 0 0 0 0 0 0 0 0 0 0 0 0 0 0 0 0 0 0 0 0 0 0 1080
1108 1108 1108 1108 0 0 0 0 0 0 0 0 0 1108 1108 1108 1108 1108 1108 1108 1108 0 0 0 0 0 0 0 0 0 0 0 0 0 0 0 0 0 0 0 0 0 0 0 0 0 0 0 0 0 0 0 0 0 0 0 0 0 0 0 0 0 0 0 0 0 0 0 0 0 0 0 0 0 0 0 0 0 0 0 0 0 0 0 0 0 0 0 0 0 0 0 1080
1108 1108 1108 0 0 0 0 0 0 0 0 0 0 0 1108 1108 1108 1108 1108 1108 1108 0 0 0 0 0 0 0 0 0 0 0 0 0 0 0 0 0 0 0 0 0 0 0 0 0 0 0 0 0 0 0 0 0 0 0 0 0 0 0 0 0 0 0 0 0 0 0 0 0 0 0 0 0 0 0 0 0 0 0 0 0 0 0 0 0 0 0 0 0 0 0 1080
1108 1108 0 0 0 0 0 0 0 0 0 0 0 0 0 1108 1108 1108 1108 1108 1108 0 0 0 0 0 0 0 0 0 0 0 0 0 0 0 0 0 0 0 0 0 0 0 0 0 0 0 0 0 0 0 0 0 0 0 0 0 0 0 0 0 0 0 0 0 0 0 0 0 0 0 0 0 0 0 0 0 0 0 0 0 0 0 0 0 0 0 0 0 0 0 1080
1108 1108 0 0 0 0 0 0 0 0 0 0 0 0 0 0 1108 1108 1108 1108 0 0 0 0 0 0 0 0 0 0 0 0 0 0 0 0 0 0 0 0 0 0 0 0 0 0 0 0 0 0 0 0 0 0 0 0 0 0 0 0 0 0 0 0 0 0 0 0 0 0 0 0 0 0 0 0 0 0 0 0 0 0 0 0 0 0 0 0 0 0 0 0 1080
1108 0 0 0 0 0 0 0 0 0 0 0 0 0 0 0 0 1108 1108 1108 0 0 0 0 0 0 0 0 0 0 0 0 0 0 0 0 0 0 0 0 0 0 0 0 0 0 0 0 0 0 0 0 0 0 0 0 0 0 0 0 0 0 1058 1058 1058 0 0 0 0 0 0 0 0 0 0 0 0 0 0 0 0 0 0 0 0 0 0 0 0 0 0 0 1080
1108 0 0 0 0 0 0 0 0 0 0 0 0 0 0 0 0 0 0 0 0 0 0 0 0 0 0 0 0 0 0 0 0 0 0 0 0 0 0 0 0 0 0 0 0 0 0 0 0 0 0 0 0 0 0 0 0 0 0 0 0 0 1083 1083 1083 0 0 0 0 0 0 0 0 0 0 0 0 0 0 0 0 0 0 0 0 0 0 0 0 0 0 0 1080
1108 0 0 0 0 0 0 0 0 0 0 0 0 0 0 0 0 0 0 0 0 0 0 0 0 0 0 0 0 0 0 0 0 0 0 0 0 0 0 0 0 0 0 0 0 0 0 0 0 0 0 0 0 0 0 0 0 0 0 0 0 0 1083 1108 1083 0 0 0 0 0 0 0 0 0 0 0 0 0 1491 1492 1493 0 0 0 0 0 0 0 0 0 0 0 1080
1108 0 0 0 0 0 0 0 0 0 0 0 0 0 0 0 0 0 0 0 0 0 0 0 0 0 0 0 0 0 0 0 0 0 0 0 0 0 0 0 0 0 0 0 0 0 0 0 0 0 0 0 0 0 0 0 0 0 0 0 0 0 1083 1108 1083 0 0 0 0 0 0 0 0 0 0 0 0 0 0 0 0 0 0 0 0 0 0 0 0 0 0 0 1080
1108 0 0 0 0 0 0 0 0 0 0 0 0 0 0 0 0 0 0 0 0 0 0 0 0 0 0 0 0 0 0 0 0 0 0 0 0 0 0 0 0 0 0 0 0 0 0 0 0 0 0 0 0 0 0 0 0 0 0 1057 1058 1058 1083 1108 1083 0 0 0 0 0 0 0 0 0 0 0 0 0 0 0 0 0 0 0 0 0 0 0 0 0 0 0 1080
1083 1058 1058 1058 1058 1058 1058 1058 1058 1058 1058 1058 1058 1058 1058 1058 1058 1058 1058 1058 1058 1058 1058 1058 1058 1058 1058 1058 1058 1058 1058 1058 1058 1058 0 0 0 1058 1058 1058 1058 1058 1058 0 0 0 1058 1058 1058 1058 1058 1058 1058 1058 1058 0 0 0 0 1083 1083 1083 1083 1083 1083 1058 1058 1058 1058 1058 1058 1058 1058 1058 1058 1058 1058 1058 1058 1058 1058 1058 1058 1058 1058 1058 1058 1058 1058 1058 1058 1058 1058
1083 1083 1108 1083 1108 1108 1108 1083 1083 1108 1083 1108 1083 1108 1083 1108 1083 1108 1083 1108 1083 1108 1108 1108 1083 1108 1108 1083 1108 1108 1083 1108 1108 1083 0 0 0 1083 1108 1108 1083 1108 1083 0 0 0 1108 1083 1108 1108 1108 1108 1083 1108 1108 0 0 0 0 1083 1108 1083 1083 1108 1108 1083 1083 1083 1108 1083 1083 1108 1108 1108 1108 1083 1083 1108 1108 1108 1083 1108 1108 1083 1083 1108 1083 1083 1108 1083 1108 1108 1108
1108 1083 1108 1083 1083 1108 1083 1108 1083 1108 1083 1108 1083 1083 1083 1108 1083 1108 1083 1083 1108 1108 1083 1083 1108 1108 1108 1083 1083 1108 1083 1083 1108 1083 0 0 0 1083 1108 1108 1108 1108 1083 0 0 0 1083 1108 1108 1083 1083 1108 1083 1083 1083 0 0 0 0 1083 1108 1108 1108 1083 1083 1083 1108 1108 1083 1083 1083 1108 1083 1083 1083 1083 1108 1083 1083 1108 1083 1108 1083 1108 1108 1083 1083 1108 1083 1083 1083 1108 1083
