TILEMAP
93 63 							-- Size of tile map in tiles
16 16 							-- Tile size & block size
images/level01.png 	            -- Tilesheet
25 25 							-- Number of tiles in tilesheet
429 429 429 429 429 429 435 436 429 429 429 429 429 429 431 1 1 1 1 427 429 429 429 429 429 429 435 436 429 429 429 429 429 429 431 1 1 1 1 1 1 1 1 1 1 1 1 1 1 1 1 1 1 1 1 1 1 1 1 1 1 427 429 429 429 429 429 429 435 436 429 429 429 429 429 429 431 1 1 1 1 1 1 1 1 1 1 1 1 1 1 1 1
429 429 429 429 429 429 460 461 429 429 429 429 429 429 431 1 1 1 1 427 429 429 429 429 429 429 460 461 429 429 429 429 429 429 431 1 1 1 1 1 1 1 1 1 1 1 1 1 1 1 1 1 1 1 1 1 1 1 1 1 1 427 429 429 429 429 429 429 460 461 429 429 429 429 429 429 431 1 1 1 1 1 1 1 1 1 1 1 1 1 1 1 1
429 429 429 429 429 429 435 436 429 429 429 429 429 455 456 1 1 1 1 452 453 429 429 429 429 429 435 436 429 429 429 429 429 455 456 1 1 1 1 1 1 1 1 1 1 1 1 1 1 1 1 1 1 1 1 1 1 1 1 1 1 452 453 429 429 429 429 429 435 436 429 429 429 429 429 455 456 1 1 1 1 1 1 1 1 1 1 1 1 1 1 17 18
452 453 429 429 429 429 460 461 429 429 429 455 479 456 1 1 1 1 1 1 452 453 429 429 429 429 460 461 429 429 429 455 479 456 1 1 1 1 1 1 1 1 1 1 1 1 1 1 1 1 1 1 1 1 1 1 1 1 1 1 1 1 452 453 429 429 429 429 460 461 429 429 429 455 479 456 1 1 1 1 1 1 1 1 1 1 1 1 1 1 1 42 43
1 478 479 453 454 454 435 436 429 429 455 456 1 1 1 1 1 1 1 1 1 478 479 453 454 454 435 436 429 429 455 456 1 1 1 1 1 1 1 1 1 1 1 1 1 1 1 1 1 1 1 1 1 1 1 1 1 1 1 1 1 1 1 478 479 453 454 454 435 436 429 429 455 456 1 1 1 1 1 1 1 1 1 1 1 1 1 1 1 1 1 1 1
1 1 1 478 479 479 460 461 455 479 480 1 1 1 1 1 1 1 1 1 1 1 1 478 479 479 460 461 455 479 480 1 1 1 1 1 1 1 1 1 1 1 1 1 1 1 1 1 1 1 1 1 1 1 1 1 1 1 1 1 1 1 1 1 1 478 479 479 460 461 455 479 480 1 1 1 1 1 1 1 1 1 1 1 1 1 1 1 1 1 1 1 1
1 1 1 1 1 1 435 436 480 1 1 1 1 1 1 1 1 1 1 1 1 1 1 1 1 1 435 436 480 1 1 1 1 1 1 1 1 1 1 1 1 1 1 1 1 1 1 1 1 1 1 1 1 1 1 1 1 1 1 1 1 1 1 1 1 1 1 1 435 436 480 1 1 1 1 1 1 1 1 1 1 1 1 1 1 1 1 1 1 1 1 1 1
1 1 1 1 1 1 460 461 1 1 1 1 1 1 1 1 1 1 1 1 1 1 1 1 1 1 460 461 1 1 1 1 1 1 1 1 1 1 1 1 1 1 1 1 1 1 1 1 1 1 1 1 1 1 1 1 1 1 1 1 1 1 1 1 1 1 1 1 460 461 1 1 1 1 1 1 1 1 1 1 1 1 1 1 1 1 1 1 1 1 1 1 1
1 1 1 1 1 1 435 436 1 1 1 1 1 1 1 1 1 1 1 1 1 1 1 1 1 1 435 436 1 1 1 1 1 1 1 1 1 39 40 41 1 1 1 1 1 1 1 1 1 1 1 1 1 1 1 1 1 1 1 1 1 1 1 1 1 1 1 1 435 436 1 1 1 1 1 1 1 1 1 1 1 1 1 1 1 1 16 1 1 1 1 1 1
1 1 1 1 1 1 460 461 1 1 1 1 1 1 1 1 1 1 1 1 1 1 1 1 1 1 460 461 1 1 1 1 1 1 1 1 1 1 1 1 1 1 1 1 1 1 1 1 1 1 1 1 1 1 1 1 1 39 40 41 1 1 1 1 1 1 1 1 460 461 1 1 1 1 1 1 1 1 1 1 1 1 1 1 1 1 1 1 1 1 1 1 1
1 1 1 1 1 1 435 436 1 1 1 1 1 1 1 1 1 1 1 1 1 1 1 1 1 1 435 436 1 1 1 1 1 1 1 1 179 179 179 179 1 1 1 1 1 1 1 1 1 1 1 1 1 1 1 1 1 1 1 1 1 1 1 1 1 1 1 1 435 436 1 1 1 1 1 1 1 1 1 1 1 1 1 1 1 1 1 1 1 1 1 1 1
1 1 1 1 1 1 460 461 1 1 1 1 1 1 1 1 1 16 1 1 1 1 1 1 1 1 460 461 1 1 1 1 1 1 179 179 179 179 179 179 1 1 1 1 1 1 1 1 1 1 1 1 1 64 1 1 1 1 1 1 1 1 1 1 1 1 1 1 460 461 1 1 1 1 1 1 1 1 1 1 1 1 65 66 1 1 1 1 1 1 1 1 1
1 1 1 1 1 1 435 436 1 1 1 1 1 65 66 1 1 1 1 1 1 1 1 1 1 1 435 436 1 1 1 1 1 1 179 179 179 179 179 179 1 1 1 1 1 1 1 1 1 65 66 1 1 1 1 1 1 1 1 1 1 1 1 1 1 1 1 1 435 436 1 1 1 1 1 1 1 1 1 1 1 1 1 1 1 1 1 1 1 1 1 1 1
1 16 1 64 1 1 460 461 39 40 41 1 1 1 1 1 1 1 1 1 1 1 39 40 41 64 460 461 16 1 65 66 1 1 179 179 179 179 179 179 1 1 1 1 1 1 1 1 1 1 1 1 1 1 1 1 1 1 1 1 16 1 39 40 41 1 1 1 460 461 1 1 16 39 40 41 1 1 1 1 1 64 1 1 1 1 1 1 1 1 1 1 1
1 1 1 1 1 1 1 1 1 1 1 1 1 1 1 1 1 1 1 1 1 1 1 1 1 1 1 1 1 1 1 1 1 1 1 1 179 179 179 179 1 1 1 1 1 1 1 1 1 1 1 1 1 1 1 1 1 1 1 1 1 1 1 1 1 1 1 1 1 1 1 1 1 1 1 1 1 1 1 1 1 1 1 1 1 1 1 1 1 1 1 1 1
1 1 1 1 1 1 1 1 1 1 1 1 1 1 1 1 1 1 1 1 1 1 1 1 1 1 1 1 1 1 1 1 1 1 1 1 179 179 179 179 1 1 1 1 1 1 1 1 1 1 1 1 1 1 1 1 1 1 1 1 1 1 1 1 1 1 1 1 1 1 1 1 1 1 1 1 179 179 179 179 1 1 1 1 1 1 1 1 1 1 1 1 1
1 1 1 1 1 1 1 1 1 1 1 1 1 1 1 1 1 1 1 1 1 1 1 1 1 1 1 1 1 1 1 1 1 1 1 1 179 179 179 179 1 1 1 1 1 1 1 1 1 1 1 1 1 1 1 1 1 1 1 1 1 1 1 1 1 1 1 1 1 1 1 1 1 1 1 1 179 179 179 179 1 1 1 1 1 1 1 1 1 1 1 1 1
1 1 1 1 1 1 1 1 1 1 1 1 1 1 1 1 1 1 1 1 1 1 1 1 1 1 1 1 1 1 1 1 1 1 1 1 179 179 179 179 1 1 1 1 1 1 1 1 1 1 1 1 1 1 1 1 1 1 1 1 1 1 1 1 1 1 1 1 1 1 1 1 1 1 1 1 179 179 179 179 1 1 1 1 1 1 1 1 1 1 1 1 1
1 1 1 1 1 1 1 1 1 1 1 1 1 1 1 1 1 1 1 1 1 1 1 1 1 1 1 1 1 1 1 1 1 1 1 1 179 179 179 179 1 1 1 1 1 1 1 1 1 1 1 1 1 1 1 1 1 1 1 1 1 1 1 1 1 1 1 1 1 1 1 1 1 1 1 1 179 179 179 179 1 1 1 1 1 1 1 1 1 1 1 1 1
1 1 1 1 1 1 1 1 1 1 1 1 1 1 1 1 1 1 1 1 1 1 1 1 1 1 1 1 1 1 179 179 179 179 179 179 179 179 179 179 1 1 1 1 1 1 1 1 1 1 1 1 1 1 1 1 1 1 1 1 1 1 1 1 1 1 1 1 1 1 1 1 1 1 1 1 179 179 179 179 1 1 1 1 1 1 1 1 1 1 1 1 1
79 1 1 179 179 179 179 179 179 179 179 179 179 179 179 179 179 179 179 179 179 179 179 179 179 179 179 179 179 179 179 179 179 179 179 179 179 179 179 179 179 179 179 179 1 1 1 1 1 1 1 1 1 1 1 1 1 1 1 1 1 1 1 1 1 1 1 1 1 1 179 179 179 179 179 179 179 179 179 179 179 179 179 179 179 179 179 179 179 179 1 1 1
179 179 179 179 179 179 179 179 179 179 179 179 179 179 179 179 179 179 179 179 179 179 179 179 179 179 179 179 179 179 179 179 179 179 179 179 179 179 179 179 179 179 179 179 179 179 179 1 1 1 1 1 1 1 1 1 1 1 1 1 1 1 1 1 1 1 179 179 179 179 179 179 179 179 179 179 179 179 179 179 179 179 179 179 179 179 179 179 179 179 179 179 1
179 179 179 179 179 179 179 179 179 179 179 179 179 179 179 179 179 179 179 179 179 179 179 179 179 179 179 179 179 179 179 179 179 179 179 179 179 179 179 179 179 179 179 179 179 179 179 179 179 179 179 179 179 179 179 1 1 1 1 1 1 1 1 1 179 179 179 179 179 179 179 179 179 179 179 179 179 179 179 179 179 179 179 179 179 179 179 179 179 179 179 179 179
179 179 179 179 179 179 179 179 179 179 179 179 179 179 179 179 179 179 179 179 179 179 179 179 179 179 179 179 179 179 179 179 179 179 179 179 179 179 179 179 179 179 179 179 179 179 179 179 1 1 1 1 1 1 1 1 1 1 1 1 1 1 1 179 179 179 179 179 179 179 179 179 179 179 179 179 179 179 179 179 179 179 179 179 179 179 179 179 179 179 179 179 179
79 179 179 179 179 179 179 179 179 179 179 179 179 179 179 179 179 179 179 179 179 179 179 179 179 179 179 179 179 179 179 179 179 179 179 179 179 179 179 179 179 179 179 179 179 179 179 179 179 179 179 179 179 179 179 179 1 1 1 1 1 1 1 1 179 179 179 179 179 179 179 179 179 179 179 179 179 179 179 179 179 179 179 179 179 179 179 179 179 179 179 179 179
179 179 179 179 179 179 179 179 179 179 179 179 179 179 179 179 179 179 179 179 179 179 179 179 179 179 179 179 179 179 179 179 179 179 179 179 179 179 179 179 179 179 179 179 179 179 179 179 179 179 179 179 1 1 1 1 1 1 1 1 1 1 1 179 179 179 179 179 179 179 179 179 179 179 179 179 179 179 179 179 179 179 179 179 179 179 179 179 179 179 179 179 1
179 179 179 179 179 179 179 179 179 179 179 179 179 179 179 179 179 179 179 179 179 179 179 179 179 179 179 179 179 179 179 179 179 179 179 179 179 179 179 179 179 179 179 179 179 179 179 179 179 179 1 1 1 1 1 1 1 1 1 1 1 1 1 179 179 179 179 179 179 179 179 179 179 179 179 179 179 179 179 179 179 179 179 179 179 179 179 179 179 179 179 179 179
1 179 179 179 179 179 179 179 179 179 179 179 179 179 179 179 179 179 179 179 179 179 179 179 179 179 179 179 179 179 179 179 179 179 179 179 179 179 179 179 179 179 179 179 179 179 179 179 179 179 179 1 1 1 1 1 1 1 1 1 1 1 1 179 179 179 179 179 179 179 179 179 179 179 179 179 179 179 179 179 179 179 179 179 179 179 179 179 179 179 179 179 1
1 1 1 1 1 179 179 179 179 179 179 179 179 179 179 179 179 179 179 179 179 179 179 179 179 179 179 179 179 179 179 179 179 179 179 179 179 179 179 179 179 179 179 179 179 179 179 179 1 1 1 1 1 1 1 1 1 1 1 1 1 1 1 179 179 179 179 179 179 179 179 179 179 179 179 179 179 179 179 179 179 179 179 179 179 179 179 179 179 179 179 179 179
1 1 1 1 1 1 1 179 179 179 179 179 179 179 179 179 179 179 179 179 179 179 179 179 179 179 179 179 179 179 179 179 179 179 179 179 179 179 179 179 179 179 179 179 179 179 179 179 179 179 179 1 1 1 1 1 1 1 1 1 1 1 1 1 1 1 1 1 179 179 179 179 179 179 179 179 179 179 179 179 179 179 179 179 179 179 179 179 179 179 179 179 179
1 1 1 1 1 1 1 1 1 1 1 1 1 1 1 1 1 1 1 179 179 179 179 1 179 179 179 1 1 1 1 1 1 179 179 1 1 1 1 1 1 1 1 1 1 1 1 1 1 1 1 1 1 1 1 1 1 1 1 1 1 1 1 1 1 1 1 1 1 1 1 1 1 1 179 179 179 179 179 179 179 179 179 179 179 179 179 179 179 1 1 1 1
1 1 1 1 1 1 1 1 1 1 1 1 1 1 1 1 1 1 1 179 179 179 179 179 1 1 1 1 1 1 1 1 1 179 1 1 1 1 1 1 1 1 1 1 1 1 1 1 1 1 1 1 1 1 1 179 179 179 179 179 179 179 179 179 179 179 179 179 179 179 179 179 179 179 179 179 179 179 179 179 179 179 1 179 179 179 179 1 1 1 1 1 1
1 1 1 1 1 1 1 1 1 1 179 179 179 179 179 179 179 179 179 179 179 179 179 179 179 179 1 1 1 1 1 1 1 179 179 179 179 179 179 179 179 179 179 179 179 179 179 179 179 179 179 179 179 179 179 179 1 1 1 1 1 1 1 1 1 1 1 1 1 1 1 1 1 1 1 1 1 1 179 179 1 179 179 179 179 179 179 179 1 1 1 1 1
1 1 1 1 1 1 1 1 1 1 1 179 179 179 179 179 179 179 179 179 179 179 179 179 179 179 179 179 179 179 179 179 179 179 179 29 29 29 29 29 29 29 29 29 29 29 29 29 29 29 29 29 29 1 1 1 1 1 1 1 1 1 179 179 179 179 179 179 179 179 179 179 179 179 179 179 179 179 179 179 179 179 179 179 179 179 179 179 179 179 179 179 1
1 1 1 1 1 1 1 1 1 1 179 179 179 179 179 179 179 179 179 179 179 179 179 179 179 179 179 179 179 179 179 179 179 179 179 179 179 179 179 179 179 179 179 179 179 1 1 1 1 1 1 1 1 1 1 1 1 1 1 1 1 1 179 179 179 179 179 179 179 179 179 179 179 179 179 179 179 179 179 179 179 179 179 179 179 179 179 179 179 179 179 179 1
1 1 179 179 179 179 179 179 179 179 179 179 179 179 179 179 179 179 179 179 179 179 179 179 179 179 179 179 179 179 179 179 179 179 179 179 179 179 179 179 179 179 179 179 179 179 1 1 1 1 1 1 1 1 1 1 1 1 1 1 1 1 1 1 1 179 179 179 179 179 179 179 179 179 179 179 179 179 179 179 179 179 179 179 179 179 179 179 179 179 179 179 179
179 179 179 179 179 179 179 179 179 179 179 179 179 179 179 179 179 179 179 179 179 179 179 179 179 179 179 179 179 179 179 179 179 179 179 179 179 179 179 179 179 179 179 179 179 179 179 179 179 1 1 1 1 1 1 1 1 1 179 179 179 179 179 179 179 179 179 179 179 179 179 179 179 179 179 179 179 179 179 179 179 179 179 179 179 179 179 179 179 179 179 179 179
1 179 179 179 179 179 179 179 179 179 179 179 179 179 179 179 179 179 179 179 179 179 179 179 179 179 179 179 179 179 179 179 179 179 179 179 179 179 179 179 179 179 179 179 179 179 179 179 179 179 179 1 1 179 179 179 179 179 179 179 179 179 179 179 179 179 179 179 179 179 179 179 179 179 179 179 179 179 179 179 179 179 179 179 179 179 179 179 179 179 179 179 179
179 179 179 179 179 179 179 179 179 179 179 179 179 179 179 179 179 179 179 179 179 179 179 179 179 179 179 179 179 179 179 179 179 179 179 179 179 179 179 179 179 179 179 179 179 179 179 179 179 179 179 179 179 179 1 1 179 179 179 179 179 179 179 179 179 179 179 179 179 179 179 179 179 179 179 179 179 179 179 179 179 179 179 179 179 179 179 179 179 179 179 179 179
179 179 179 179 179 179 179 179 179 179 179 179 179 179 179 179 179 179 179 179 179 179 179 179 179 179 179 179 179 179 179 179 179 179 179 179 179 179 179 179 179 179 179 179 179 179 179 179 179 179 179 179 179 179 179 179 179 179 179 179 179 179 179 179 179 179 179 179 179 179 179 179 179 179 179 179 179 179 179 179 179 179 179 179 179 179 179 179 1 1 1 1 1
1 29 179 179 179 179 179 179 179 179 179 179 179 179 179 179 179 179 179 179 179 179 179 179 179 179 179 179 179 179 179 179 179 179 179 179 179 179 179 179 179 179 179 179 179 179 179 179 179 179 179 179 179 179 179 179 179 179 179 179 179 179 179 179 179 179 179 179 179 179 179 179 179 179 179 179 179 179 179 179 179 179 179 179 179 179 179 179 1 1 1 1 1
1 29 29 179 179 179 179 179 179 179 179 179 179 179 179 179 179 179 179 179 179 179 179 179 179 179 179 179 179 179 179 179 179 179 179 179 179 179 179 179 179 179 1 179 179 179 179 179 179 179 179 179 179 179 179 179 179 179 179 179 179 179 179 179 179 179 179 179 179 179 179 179 179 179 179 179 179 179 179 179 179 179 179 179 179 1 1 1 1 1 1 1 1
29 29 29 29 29 179 179 179 179 179 1 1 1 1 1 1 1 1 1 1 1 1 1 1 1 1 1 1 1 1 1 1 1 1 1 1 1 1 1 1 1 1 1 1 1 1 1 179 179 179 179 179 179 179 179 179 179 179 1 1 1 1 1 1 1 1 1 1 179 179 179 179 179 179 179 179 179 179 179 179 179 1 1 1 1 1 1 1 1 1 1 1 1
1 1 1 1 1 54 54 54 54 54 1 1 1 1 1 1 1 1 1 1 1 1 1 1 1 1 1 1 1 1 1 1 1 1 1 1 1 1 1 1 1 1 1 1 1 1 1 1 1 1 1 1 1 1 1 1 1 1 1 1 1 1 1 1 1 1 1 1 1 1 1 1 1 1 1 1 1 1 1 1 1 1 1 1 1 1 1 1 1 1 1 1 1
1 1 1 1 1 54 54 54 54 54 1 1 1 1 1 1 1 1 1 1 1 1 1 1 1 1 1 1 1 1 1 1 1 1 1 1 1 1 1 1 1 1 1 1 1 1 1 1 1 1 1 1 1 1 1 1 1 1 1 1 1 1 1 1 1 1 1 1 1 1 1 1 1 1 1 1 1 1 1 1 1 1 1 1 1 1 1 1 1 1 1 1 1
1 1 1 1 1 54 54 54 54 54 1 1 1 1 1 1 1 1 1 1 1 1 1 1 1 1 1 1 1 1 1 1 1 1 1 1 1 1 1 1 1 1 1 1 1 1 1 1 1 1 1 1 1 1 1 1 1 1 1 1 1 1 1 1 1 1 1 1 1 1 1 1 1 1 1 1 1 1 1 1 1 1 1 1 1 1 1 1 1 1 1 1 1
1 1 1 1 1 54 54 54 54 54 1 1 1 1 1 1 1 1 1 1 1 1 1 427 429 429 429 429 429 429 435 436 429 429 429 429 429 429 431 1 1 1 1 1 1 427 429 429 429 429 429 429 435 436 429 429 429 429 429 429 431 1 1 1 1 1 1 1 1 427 429 429 429 429 429 429 435 436 429 429 429 429 429 429 431 1 1 1 1 1 1 1 1
1 1 1 1 1 54 54 54 54 54 1 1 1 1 1 1 1 1 1 1 1 1 1 427 429 429 429 429 429 429 460 461 429 429 429 429 429 429 431 1 1 1 1 1 1 427 429 429 429 429 429 429 460 461 429 429 429 429 429 429 431 1 1 1 1 1 1 1 1 427 429 429 429 429 429 429 460 461 429 429 429 429 429 429 431 1 1 1 1 1 1 1 1
1 1 1 1 1 54 54 54 54 54 1 1 1 1 1 1 1 1 1 1 1 1 1 452 453 429 429 429 429 429 435 436 429 429 429 429 429 455 456 1 1 1 1 1 1 452 453 429 429 429 429 429 435 436 429 429 429 429 429 455 456 1 1 1 1 1 1 1 1 452 453 429 429 429 429 429 435 436 429 429 429 429 429 455 456 1 1 1 1 1 1 1 1
1 1 1 1 1 54 54 54 54 54 1 1 1 1 1 1 1 1 1 1 1 1 1 1 452 453 429 429 429 429 460 461 429 429 429 455 479 456 1 1 1 1 1 1 1 1 452 453 429 429 429 429 460 461 429 429 429 455 479 456 1 1 1 1 1 1 1 1 1 1 452 453 429 429 429 429 460 461 429 429 429 455 479 456 1 1 1 1 1 1 1 1 1
1 1 1 1 1 54 54 54 54 54 1 1 1 1 1 1 1 1 1 1 1 1 1 1 1 478 479 453 454 454 435 436 429 429 455 456 1 1 1 1 1 1 1 1 1 1 1 478 479 453 454 454 435 436 429 429 455 456 1 1 1 1 1 1 1 1 1 1 1 1 1 478 479 453 454 454 435 436 429 429 455 456 1 1 1 1 1 1 1 1 1 1 1
1 1 1 1 1 1 1 1 1 1 1 1 1 1 1 1 1 1 1 1 1 1 1 1 1 1 1 478 479 479 460 461 455 479 480 1 1 1 1 1 1 1 1 1 1 1 1 1 1 478 479 479 460 461 455 479 480 1 1 1 1 1 1 1 1 1 1 1 1 1 1 1 1 478 479 479 460 461 455 479 480 1 1 1 1 1 1 1 1 1 1 1 1
1 1 1 1 1 1 1 1 1 1 1 1 1 1 1 1 1 1 1 1 1 1 1 1 1 1 1 1 1 1 435 436 480 1 1 1 1 1 1 1 1 1 1 1 1 1 1 1 1 1 1 1 435 436 480 1 1 1 1 1 1 1 1 1 1 1 1 1 1 1 1 1 1 1 1 1 435 436 480 1 1 1 1 1 1 1 1 1 1 1 1 1 1
1 1 1 1 1 1 1 1 1 1 1 1 1 1 1 1 1 1 1 1 1 1 1 1 1 1 1 1 1 1 460 461 1 1 1 1 1 1 1 1 1 1 1 1 1 1 1 1 1 1 1 1 460 461 1 1 1 1 1 1 1 1 1 1 1 1 1 1 1 1 1 1 1 1 1 1 460 461 1 1 1 1 1 1 1 1 1 1 1 1 1 1 1
1 1 1 1 1 1 1 1 1 1 1 1 1 1 1 1 1 1 1 1 1 1 1 1 1 1 1 1 1 1 435 436 1 1 1 1 1 1 1 1 1 1 1 1 1 1 1 1 1 1 1 1 435 436 1 1 1 1 1 1 1 1 1 14 1 1 1 1 1 1 1 1 1 1 1 1 435 436 1 1 1 1 1 1 1 1 1 1 1 1 1 1 1
1 1 1 1 1 1 1 1 1 1 1 1 1 1 1 1 1 1 1 1 1 1 1 1 1 1 1 1 1 1 460 461 1 1 1 1 1 1 1 1 1 1 1 1 1 1 1 1 1 1 1 1 460 461 1 1 1 1 1 1 1 1 1 1 1 1 1 1 1 1 1 1 1 1 1 1 460 461 1 1 1 1 1 1 1 1 1 1 1 1 1 1 1
1 1 1 1 1 1 1 1 1 1 1 1 1 1 1 1 1 1 1 1 1 1 1 1 1 1 1 1 1 1 435 436 1 1 1 1 1 1 1 1 1 1 1 1 1 1 1 1 1 1 1 1 435 436 1 1 1 1 1 1 1 1 1 1 1 1 1 1 1 1 1 1 1 1 1 1 435 436 1 1 1 1 1 1 1 1 1 1 1 1 1 1 1
1 1 1 1 1 1 1 1 1 1 1 1 1 1 1 1 1 1 1 1 1 1 1 1 1 1 1 1 1 1 460 461 1 1 1 1 1 1 1 1 1 1 1 1 1 1 1 1 1 1 1 1 460 461 1 1 1 1 1 1 1 1 1 1 1 1 1 1 1 1 1 1 1 1 1 1 460 461 1 1 1 1 1 1 1 1 1 1 1 1 1 1 1
1 1 1 1 1 1 1 1 1 1 1 1 1 1 1 1 1 1 1 1 1 1 1 1 1 17 18 1 1 1 435 436 1 1 1 1 1 1 1 17 18 1 1 1 1 1 1 1 1 1 17 18 435 436 1 1 1 1 1 1 65 66 1 1 1 1 1 1 1 1 1 1 1 1 1 1 435 436 1 1 1 1 1 1 1 1 1 1 1 1 1 1 1
1 1 1 39 40 41 1 14 1 1 1 39 40 41 1 65 66 1 39 40 41 1 65 66 1 42 43 1 39 40 460 461 14 1 1 1 1 1 14 42 43 1 1 1 1 1 39 40 41 1 42 43 460 461 14 1 1 1 1 1 1 1 1 1 1 64 1 39 40 41 1 14 39 40 41 64 460 461 40 41 14 1 1 1 39 40 41 1 14 1 39 40 64
1 1 1 1 1 1 1 1 1 1 1 1 1 1 1 1 1 1 1 1 1 1 1 1 1 1 1 1 1 1 1 1 1 1 1 1 1 1 1 1 1 1 1 1 1 1 1 1 1 1 1 1 1 1 1 1 1 1 1 1 1 1 1 1 1 1 1 1 1 1 1 1 1 1 1 1 1 1 1 1 1 1 1 1 1 1 1 1 1 1 1 1 1
1 1 1 1 1 1 1 1 1 1 1 1 1 1 1 1 1 1 1 1 1 1 1 1 1 1 1 1 1 1 1 1 1 1 1 1 1 1 1 1 1 1 1 1 1 1 1 1 1 1 1 1 1 1 1 1 1 1 1 1 1 1 1 1 1 1 1 1 1 1 1 1 1 1 1 1 1 1 1 1 1 1 1 1 1 1 1 1 1 1 1 1 1
1 1 1 1 1 1 1 1 1 1 1 1 1 1 1 1 1 1 1 1 1 1 1 1 1 1 1 1 1 1 1 1 1 1 1 1 1 1 1 1 1 1 1 1 1 1 1 1 1 1 1 1 1 1 1 1 1 1 1 1 1 1 1 1 1 1 1 1 1 1 1 1 1 1 1 1 1 1 1 1 1 1 1 1 1 1 1 1 1 1 1 1 1
